A
B 1 2 3 4
A
C 5 6 7 8
A
D 6 3 4 1
B
C 9 8 7 6
B
E 0 0 0 0
E
D 5 6 4 7